1111111111
10P01000X1
1110010001
110X010101
1000000111
11X1010001
11E0000011
101010X001
11X1101111
1111111111