1111111111111111111111111111111111111111111111111111111111111111111111111111111111111111111111111111
1X10010011100X1X00001111000000000X1C0000C00001000X000000C01X00010010000001100100X10100010X1101000X01
10C0100C001000001C00100X00X1000X00000000X010000X010010000X1000101000X0X0X100011C000X01C10110010X0101
1100000000010000X000000X000001010010X0X00000000000100000X00CX010100C00000000000001000100X00001101001
101000000000000000XX0000101000000X10000C0000000000C0C00X00CX00000101000100000110C000000010000000C0X1
1001X0001100001101001X00001C0X00100C0C111010000X000000000100000101C00000000000101000010001000C000001
10000X0C00000X001C00101111000000100100000000C10X0000C000000C000110000001X010000010C100011X0000000011
1000001X1000000001110000001001110CX00010C0X0010010000100101000C0000X000C0000001100000101000000000001
1C10000010011X0C00000000000010010000000000C0C11010010C0C001000000000X1000001000001000000C0101C000101
10001C000X010100000C00010000001100001000X000000CX00100100010000C010000000000000100000000X11101100011
10X000000XX00000C000010000000X111100000010000010100100000011C0X000X0100C00111000001C0000000000111001
1X01010000000010000010001000X100011001X0000000100000001000000C000010000000XC000C0000100C100000001011
110X1X1001000000001010XC000C0000001011000CC00000C000010000X100000X0000C10C010001000X01110001001010X1
1001110X1101000000X0C0X1110000CC10000000000000001X00000110110100000X0001001001C1001000C0000010100001
100000000X000X000CC0XCC100X0000110C00000000010000000010100110000010000XCX1001000000000000001000X1C01
1000000X01000011C0010000000C1C010X100000C00001110000000100011X01C1X000000000C110011C100000000X011011
1000001XX010C010000000000010000000000111101X01110100000000001X00100000000011000010000X00100000XC00C1
1000000CC0000000000000000010000010000100001100000101X000100000XC001000100C10100001000001CX00X110X111
1XX1XX00XC001001X0C0010C1C000X000100000000000000X10100100100000010000C10010X00000000000000C00C001011
10100X0000000000001000000101000100000001001C110000000001X100010000X000010000000010000100000010000001
100000001000001110X000000C000101001000010011000001100000000011000000100010010010100010100100100000X1
10010000000000100X000100000000010010000100000000100X0C00X001000000000001000000000X0000000000X1X00001
100001010X1100000C0C00000000X110000XX1001010100C0100C0X0110001X10000100C0C01000110000C00001000001001
100100000001011010010CC0C0010000CC010000000000010101C001C00000C100001101C00000X00100001000001X000001
100100C00000001000000001100100000000000010C01000100C1000C100000001C000000000X10010100001000110010001
100X001000000000000100010101000110X00000011C1CC00010100000CX000010011000010000C0100000X000010C0X1001
1C0000000001X00000000000XC100000000C0C0000C0000100001110X0C101011001010000X0010000111000101010001001
10001000010000X001001001010001C00CXX0111000000010010011000110010010X000C000C0000000000010101010C0001
10000010000100CX000X0C00100000000100000X01100000X00000000001000C0X0100000001000100111010C0CX00100C11
100001110011011000100C0010101XX0X0000000000000000100000C00000C0001010000X010000010001110000XCCC100C1
1X0C0CX000010111000000111111X11000C0000C0000100010000X0C000010000000100C00100010C0100X00010X10100101
10000C000001001X010001000000000C0010000C00000100100000100000000CX00100000000010C0C0001100000010C00X1
1000C00000000C0C0CXC000X0X0000000X0001000000100100110000000000001C010010X000X0000000X00000C000100011
11X000X100C000000100X00000000100110000010000C111010001010000000100010CX00000C001000000X1010000100011
100100100C001100C00X1X0000X000X0X001000000C0X00001000000C101C1000001C01000000001X000000C0100000000C1
111X0000001010001101001000X10000000010000001000100000000000000100000X10010000001001X00110100010C00C1
1000001100101010000011000C1010000X000X100001000101C000010C0XC000000001100X1010100000110C000100000001
1100010X1110000C0000C1C00X0000100000000000C1011C0000001011000100001100000000000C00000X00C00000000001
10000000000000C00C1C0000011110000X000101X10000000X00X01X000C0011010X000001X0001010X0000001100X010101
10000100000X000000XC00000X00000000X0010CC0000C010110000XX000000C1110001000010001X0000110C010C0000001
11010000C011000001001010000010101001000000010000001001100000001011000010000000101CXC0000001X00001001
10CX0100010001000000000000C010010010C0000011010001X1010001X00001000100X1C00C01010001X001000100000001
10001001001X0000P000C000001000010000000001001X00C100011X1100000000C1C10011000010000010000C0000011001
10C10000000001001X0001010110X010000000010000C00X0001X00X001101000000000000010000000000110000010011C1
10C0000000100000000000100001000C0C0000C01001000001000010000100000000C0010110000111C0C010000000001001
1010X000001001000XC100000000000C00000000000111000000000X000000C00C01000X001001000X00X000001010001001
100000X000010000C0100000011C0000110000001010C1101100110000000011000001X00X00000000C100001100101C1111
1C000010100000100C001000001X00000C00010000010000000101111000100C00000000XX1100000010100000010110X001
10000101000X001100100000100001000100000100000001000000100001000C010X00000101000001001000000010001001
1X1100X100CC00001X00XC0100000000X010X0C0000C00000001000X00111C0000000000000000011X0X0X00001000110101
1000000X00110000C0X0000000010X110XX1000101X100010000000000000C000100000CCC11X0000100XX00000000C01111
100000100C1X00000000C00000110X00100001000C1011010X000000000001XX000100000C1000101C001000000000X0X001
10XX1010000010X0000X000000CC10C01000010000000000110000CX00110000110000000010C10110000X10C000000XC011
100010000101100011000110000C0100000010X0010C000CX0010000000000X0X101X000000100100110000000000000C001
1X0C00C0X01X00000000000XX0X0001000100110XX00X011X000010000000110X0001000000000X1000000XX001000100001
10C000C0000000101X01000X000100001001X000100010000X0E00000000000000C00110001000C000000X0000000X0C0001
1000000000000C01000C000001010C01C1000000000C00010001010001001010100C00000000000001XXX00101C000X00001
1100011001X0000011010100X010010000C010000000X000000100000X00010100000001100C0000100X010X1101C0000001
10X00001000X000001C0111C11X000X010000C000000000000000X0000X00000000X10010000000001000000000100X10001
1X00X101C00110010000000X1X001C100010010CX11CC1001010100000000X00C00C0C1X00011C1X11001100000000100001
1000101000X0C000C00000001001000000001010000X00110C10000100XC01000CC101010000100101001100001000110011
101C10X10001110011100C00100000100X00XC010000C000000000000000000000C000100C000000001010C0000100000001
10101000111110111000010001X00100000000001X1000000000000000001000000010000010X001011CX10110000000X001
100001X10000000000100100011000X10001010000000C010100010000000100000000010100000000001001101000101X01
10000000000C1001010000000C010100100C00XX0000000C0C00000001010001001000110XXC0C101X101C00100000011001
1010100010CCC00C1001000000100000C000000000C00C00000001000X100100000100C01000000CC0011000000100010001
10000000010000010001011000X0000C110011010X00C10010101000100000100X110C0XX001100001000000000000X00C01
10010000101000000X010001010000100C0001C0000000010000C000000000101X00X00100001000000C0000001001010001
1000000001001C0000C011000X0XXC010000000X00000010010X01000100100000100101010001X000000X0000000000X001
101X000XX0CX00X000C11100001000100000000000000010C001C1001000001X010000011C0001000X01C00010101CX01011
10X00001000000X0C001000010100000001010C00X0010011000C00110000000000100000C100000000C00001CC000011X01
100011000110000X00000011100101011X00C0000XX0000C000C0000001C1100001100010100000001001011000010110011
1000000000110C1011000100010010000C100100000010000000001C0100000101X000001000100X0C000100C00000000X01
1X0C01010010000000100000000000000101001C0010010000011XX1000001X0101C01000101X0010001C10000010C000001
1010100110010C00000010001010000X0100CC01000100010C00C000010100000X0010010000001110001000000010000001
110011000001000000110010000101010111C110100000111X1110010000100000010010000C000000001000000000100001
1000000010001000100100XC0101000X0X00000000001000010000100001X0X00C0100001000000XC0010000100010000101
1C000C00X0011101000100000010000C0X000000X00X0000100100100010000000C0C10101000C00X10100001100000000X1
1X01100000000000000010001001000001C000100000000000100000011000C000000000C010011000100010X00010100011
1C00X101010110X01C0CX000000000001001011100000001C000011C00000X0100010010001000000CX0C0101C01C0000C01
10100100000000001001000X0001100000011C0X1100100X1001000XX010010C000100101000X00100X00010000000010011
100000101C0000000000100100000000010000011C0CC00C010100111110C0000000X000000C1000C0C00000001000C0C011
10C0X01101X010C00100C00X000000000101001100000000000C10000000000010C0110100X00CX100001100000010100001
1110100C0110000000001000001011X00000111000100001001000X10000CCC000C000011110010100100000000000000011
10000XX000X00001000010C000100000C1C100000001X0001000100X00001100000011101110C00C000000000C00000C1001
11C0X01C0001X0001X00001C00000000X0C0001000001011101X0000000X00000C0110010010000000100000100001X000C1
101C01000100000000000000010000001X01000010X1X00110XC10000010000X001001000000X000X0001000000000010001
1001X1C101C000100000110000C01X0010000C0000X0000000001C010100000100X0000X00000CX010000000000001000001
1001110010X1C000X000111C0000C0001100010000000000111X0000000000011X000000100X0C000101X000000010100101
10101110000001C000CX00000001X000001001000000C00X0010100C010000000001X0000101C00000100001000000000001
1CC000010000000C0001100100000010000C00000000C0110CX01X000101000001000C00C000001000000000101000110101
10000C0001000100C0X000C000000X010000X0100000C000001000000100X0100000010100100000C00001X110000C0C0001
101000000000000000100000010C000C1010000001X0001C101000100X0001001010C0000000000000X010001X0100000011
1000000010000010X00X000100000C000100X010101C0001000001100000XX0X0000X0X001000000C10000X00010001X0C01
1000010X001X10101000C1100100000100000X1000001000C100X0010000010100000011010C0101100000X001X001XX00C1
1X000010000000000000000010X0010C1X01C0100C0101000100000000X0000000X1C100001X000001X000000010C1011101
100110110100000000000X01000010100000000000001C0000000001100101000000010C0001000100000C10000001000111
100000001010010C0000010000C0C1000000010010X001C1000000X00100000010000X00X01000010010000C100000C00001
111101100110X00100X0000X00000X0C11C010101100001000000C00000C0000000C1110000000C00100100X1111000X01X1
1111111111111111111111111111111111111111111111111111111111111111111111111111111111111111111111111111