1111111111111111111111111111111111
1000P00000000000000000C0000X000E11
1111111111111111111111111111111111