11111111111111111111
1000C00X00011X0C0001
10010X00100C10X0X001
1C000000010000100X11
10110100000001000001
11C1000100101X011001
1000000000000C100101
10010100101010CX0001
1000001C000000X000C1
11101000001100100001
111C1000001000011X01
10000100X00110001111
1000X0C00C1C00X00001
1X0X010C000000001011
101C00XX11001000CC01
100000000X0010000011
10110C01001000C10001
1000000X0000000E1001
10C1010000011000X101
11111111111111111111