11111111111111111111
100000001000000000C1
11011110101111110111
1E000010001001010C11
11111111X01001011111
1000000000C000000001
11010111111111001101
1100001001C101000101
11011110010P01011101
1000C000011101010001
10111110001101011101
10100C1000000101C001
10101110111111011101
1000010X001C00000001
11111111111111111111