11111111111111111111
10000000000000000001
100000000100C0100001
100XC000101001E10001
10000001000010001001
10000100000100X1C001
10001010001000001001
1C010001010000010001
10100X00100000100001
100100000001C0010001
10001000001010001001
1000P100010001000001
10X01010100000100001
10000001001000001001
1101000001X10000C101
10101000100010001001
10000101000001010001
1010001000C000100001
10C100000000000000C1
11111111111111111111