111111111111111
10000000C101C01
1000P000X00C001
100001000000001
1X000100C001001
110001000001001
1000000000000C1
1E000000X000001
111111111111111
